login,2022-06-13T09:39:52Z,2022-08-13T09:39:52Z,2022-10-13T09:39:52Z,2022-12-13T09:39:52Z,2023-02-01T00:00:00Z,2023-04-01T00:00:00Z,2023-06-01T00:00:00Z,count
aSpite,0,0,0,0,1,2,2,5
sorokin0andrey,0,0,0,0,0,1,1,2
PolyProgrammist,0,0,0,2,3,3,3,11
NewKamen,0,0,0,0,0,0,1,1
aplotvinov,0,1,1,1,1,1,1,6
Miandic,0,0,0,0,1,1,1,3
markokhman,0,0,0,0,1,1,1,3
mytonwalletorg,0,0,0,0,0,1,1,2
LevZed,0,0,1,2,2,2,2,9
dvlkv,0,0,2,3,3,4,4,16
Gusarich,0,0,0,6,26,29,35,96
ProgramCrafter,0,0,0,0,3,4,4,11
tonkongz,0,1,1,1,1,1,1,6
thekiba,0,0,0,0,1,1,2,4
miroslav-tashonov,0,0,0,0,0,1,1,2
codxer007,0,0,0,0,0,1,1,2
reveloper,0,0,0,0,0,1,1,2
shayan-shojaei,0,0,0,0,1,1,1,3
xssnick,0,0,2,4,4,5,5,20
KuznetsovNikita,0,0,0,0,0,3,3,6
delovoyhomie,0,0,0,2,15,32,62,111
anomaly-guard,0,0,0,1,1,1,1,4
Hiyorimi,0,21,30,47,52,52,52,254
krau5,0,0,0,0,0,0,1,1
menschee,0,0,1,3,3,3,3,13
coalus,0,0,0,1,2,2,2,7
AndreyBurnosov,0,0,0,1,1,1,2,5
sobolevn,0,0,3,6,7,7,7,30
siandreev,0,0,0,0,0,0,1,1
purp1le,0,0,1,1,1,1,1,5
SwiftAdviser,0,0,1,1,1,1,1,5
omahs,0,0,0,0,2,2,2,6
tsivarev,0,14,15,15,15,15,16,90
stspbu,0,0,0,0,1,1,1,3
